10.0 0.5 10 1 1 1
20.7 0.8 10 1 1 1
21.2 1.7 10 1 1 1
22 3.7 10 1 1 1
21.4 6.8 10 1 1 1
20.4 7.5 10 1 1 1
19.75 7.1 10 1 1 1
19.4 6.3 10 1 1 1
20 4.6 10 1 1 1
20.1 3.5 10 1 1 1
19.3 2.7 10 1 1 1
17.9 2.0 10 1 1 1
11.8 1.5 10 1 1 1
11 1.9 10 1 1 1
10.7 2.3 10 1 1 1
10.9 2.8 10 1 1 1
11.5 3.2 10 1 1 1
17.4 3.9 10 1 1 1
18.1 4.9 10 1 1 1
17.9 5.6 10 1 1 1
17.5 5.9 10 1 1 1
16.6 5.8 10 1 1 1
15 5.3 10 1 1 1
1.3 6.5 10 1 1 1
0.75 6 10 1 1 1
0.8 5.2 10 1 1 1
1.2 3.3 10 1 1 1
1.6 2.6 10 1 1 1
2.7 2.3 10 1 1 1
7.5 2.1 10 1 1 1
8.9 0.8 10 1 1 1
